cccctwwwwcccwwTwwCCC    C
c                       C
w                       w
w                       w
w             g         w
w                       h
W                       w
w                       w
W                       w
w                       w
w                       w
w                       w
wF                      w
wp       f              w
wwWwwwbbbbbwccCCwwww    w