wwwwwwwwwwwwwwwwwwww    w
wtt  t  t  t  t wtF     w
wtT  ww wwww    www     w
wtT        w            w
w       b  wwww         w
w             wwc       w
W   tThH  b   wwC       w
w             wWw       w
Ws     bb     wwC       w
ws +   bb               w
ws +      g             w
wtGb   b    G           w
w       wWw             w
wp >>>  wfw             w
wwWwwwwwwwwwccCCwwww    w
