wwwwwwwwwwwwwwwwwwww   tw
w               w F     w
w    ww wwww    www     w
w          w            w
w       b  wwww         w
w             wwc       w
W         b   wwC       w
w             wWw       w
Ws     bb     wwC       w
ws +   bb               w
ws +      g             w
w Gb   b    G           w
w       wWw             w
wp >>>  wfw             w
wwWwwwwwwwwwccCCwwww    w